############
....###
...##.#.####
..##..###..#
.##........#
.#...@..#..#
.###..###..#
...#..#....#
..##.##.#.##
..#......##
..#.....##
..#######