#######
#..@####
#...#..#
#......#
#######