#####...#####
#...........#
#...........#
#...........#
.............
.....@.......
.............
#...........#
#...........#
#...........#
#####...#####

