###...####
#.#......#
#...#....#
..........
....@.....
..........
#........#
#...#....#
#........#
###...####