######
#@.#########
#.......#
#.......#
#......#..#
###..###..#
..#..#....#
.#...#...##
.#..#...##
.#.....##
.#######